    #####
    #   #
    #$  #
  ###  $##
  #  $ $ #
### # ## #   ######
#   # ## #####  ..#
# $  $        $ ..#
##### ### #@##  ..#
    #     #########
    #######